     
        
          
           
           sdasda
            asda

NO /home/mstracke/development/cub3D/test/blue_stone.xpm

SO /home/mstracke/development/cub3D/test/color_stone.xpm

WE /home/mstracke/development/cub3D/test/purple_stone.xpm

EA /home/mstracke/development/cub3D/test/grey_stone.xpm


F asda 164 ,asda 169 , 0

C asda   s  153 , ss204 , 255,,,,,adsda


1111111111111111111111
     11000001000000000001
101010101011111110001
100010100010000010001
111110101111101011101
100000101000101000001
1011111010111 01111111
1010000010101 00000101
10101111101011111 0101
101010001010100010101
111111101011111011101
100000101000100010001
101110101110101110111
101000100000100010101
101011111111111010101 
100010000                000000010001    
1010101110111111     00001
1N1000001000000000001
111111111111111111111


101000100000100010101
101011111111111010111
100010000000000010010
101010111011111100010
1N1000001000000000001
111111111111111111111
s
s

think about rules when a map is wrong
