     
        
          
           
           sdasda
            asda
  NO ./north.png
 SO ./south.png
   WE ./west.png
  EA ./east.png
asdadsaaa
as
  F 220,100,0

C 229 ,   20 ,                   222

as
sa
asa

111    1111111 111111111111111111
111    1100001     10000001 10011
       11111111111110000001 11101
  111         1000000000001 11111   1
1111111111111 1001110000001      
100000000011111001100111111111111
1111101111111 1011100000010001
1111101111111 101110101N010011
   1000001101 101110000010001
   10000000 1 1001100000010011
   1111111101 10111010100100011
1111111111111 11111110111100011
  111     111 111 1101111010011
  1111    111 111 1111111111111





