     
        
          
           
           sdasda
            asda

NO /home/mstracke/development/cub3D/test/blue_stone.xpm

SO /home/mstracke/development/cub3D/test/color_stone.xpm

WE /home/mstracke/development/cub3D/test/purple_stone.xpm

EA /home/mstracke/development/cub3D/test/grey_stone.xpm


F asda 164 ,asda 169 , 0

C asda   s  153 , ss204 , 255,,,,,adsda


1111 1111111111111111
1100 0001000000000001
1010 0101011111110001
1000 0100010000010001
111110101111101011101
100000101000101000001
101111101011101111111
101000001010100000101
101011111010111110101
101010001010100010101
111111101011111011101
100000101000100010001
101110101110101110111
101000100000100010101
101011111111111010101 
100010000000000010001    
101010111011111100001
1N1000001000000000001
111111111111111111111


101000100000100010101
101011111111111010111
100010000000000010010
101010111011111100010
1N1000001000000000001
111111111111111111111
s
s

think about rules when a map is wrong
