     
        
          
           
           sdasda
            asda
  NO ./north.png
 SO ./south.png
   WE ./west.png
  EA ./east.png


  F asda -220 ,asda 100 , 0

   C asda 220  s  20 sadasdadsa12 222333





111    1111111 111111111111111111
111    1100001     10000001 10011
       11111111111110000001 11101
  111         1000000000001 11111   1
1111111111111 1001110000001      
100000000011111001100111111111111
1111101111111 1011100000010001
1111101111111 1011101010010001
   1000001101 10111000S0010001
   10000000 1 1001100000010001
   1111111101 10111010100100011
1111111111111 11111110111100011
  111     111 111 1101111010011
  1111    111 111 1111111111111
                                                  
  
     

maybe use ft_strlcat(temp1, line, (ft_strlen(temp1) + ft_strlen(line) + 1)) instead
	//(difficult without being able to use realloc)
	// ft_strlcat(temp1, line, (ft_strlen(temp1) + ft_strlen(line) + 1));