NO ./north.png
SO ./south.png
WE ./west.png
EA ./east.png

F 220, 100, 0
C 20, 100, 150

11111111111
10000000001
10000000001
100000000N1
11111111111