NO ./data/blue_stone.png
SO ./data/purple_stone.png
WE ./data/color_stone.png
EA ./data/grey_stone.png

F 220,100,0
C 20, 100, 230

11111111111
1000000S001
10001000001
10000100001
10000000001
11111111111
