NO ./data/blue_stone.png
SO ./data/purple_stone.png
WE ./data/color_stone.png
EA ./data/grey_stone.png


F 220,100,0

C 229 ,   20 ,                   222

111111111111111111111111111111111111111
       11111111111110000001 11101111111
  111         1000000000001 11111   1
1111111111111 100111000000E
1000000000111 1001100111111111111
1111101111111 1011100000010001
1111101111111 1011101010010011
   1000001101 101110000010001
   10000000 1 1001100000010011
   1111111101 10111010100100011
1111111111111 11111110111100011
  111     111 111 1101111010011
  1111    111 111 1111111111111





