NO ./data/blue_stone.png
SO ./data/purple_stone.png
WE ./data/color_stone.png
EA ./data/grey_stone.png

F 220,100,0
C 20, 100, 23066,2332

11111111111
10000000001
10000000001
10000100001
1000000000W
11111111111
