NO ./north.png
SO ./south.png
WE ./west.png
EA ./east.png

F 220, 100, 0
C 20, 100, 150

d11111111111
ds10000000001
ds10000000001
d10000100001
d100000000E1
d11111111111

1111
11E1
1111
