NO ./data/blue_stone.png
SO ./data/purple_stone.png
WE ./data/color_stone.png
EA ./data/grey_stone.png


F 164 , 169 , 0

C 153 , 204 , 255


1111 1111111111111111
1101 1001000000000001
1011 1101011111110001
1001 1100010000010001
111111101111101011101
100000101000101000001
101111101011101111111
101000001010100000101
101011111010111110101
101010001010100010101
111111101011111011101
100000101000100010001
101110101110101110111
101000100000100010101
101011111111111010101 
100010000000000010001    
101010111011111100001
101000001000000000001
111111111111111111111
 
 
111111111111111111111
101000100000100010101
101011111111111010111
100010000000000010011
101010111011111100011
1N1000001000000000001
111111111111111111111
