     
        
          
           
           sdasda
            asda

NO 	./data/blue_stone.png
SO 	./data/purple_stone.png
WE 	./data/color_stone.png
EA 	./data/grey_stone.png


F asda 233 ,asda 0 , 0

C asda   s  0 , ss0 , 230,,,,,adsda


       1111111 111111111111111111
       1100001     10000001 10011
       11111111111110000001 11101
  111         1000000000001 11111   1
1111111111111 1001110000001      
1000000000111 10011N0111111111111
1111101111111 1011100000010001
1111101111111 1011101010010001
   1000001101 1011100000010001
   1000000001 1001100000010001
   1111111101 10111010100100011
1111111111111 11111110111100011
  111     111 111 1101111010011
  1111    111 111 1111111111111

adapt strategy to east and north

s
s

think about rules when a map is wrong
